"Subsystem Name"	"Subsystem Merged"
"2-aminophenol Metabolism"	"2-aminophenol Metabolism"
"2-ketoacid oxidoreductases disambiguation"	"2-ketoacid oxidoreductases disambiguation"
"2-O-alpha-mannosyl-D-glycerate utilization"	"2-O-alpha-mannosyl-D-glycerate utilization"
"2-oxoglutarate dehydrogenase"	"TCA Cycle!2-oxoglutarate dehydrogenase!Lipoylated proteins"
"2-phosphoglycolate salvage"	"2-phosphoglycolate salvage"
"2,3-diacetamido-2,3-dideoxy-d-mannuronic acid"	"2,3-diacetamido-2,3-dideoxy-d-mannuronic acid"
"3-amino-5-hydroxybenzoic Acid Synthesis"	"3-amino-5-hydroxybenzoic Acid Synthesis"
"4-hydroxybenzoyl-CoA reductase"	"4-hydroxybenzoyl-CoA reductase"
"5-methylaminomethyl-2-thiouridine"	"5-methylaminomethyl-2-thiouridine"
"5-nitroimidazole antibiotic resistance"	"5-nitroimidazole antibiotic resistance"
"A Hypothetical Protein Related to Proline Metabolism"	"A Hypothetical Protein Related to Proline Metabolism"
"A new toxin - antitoxin system"	"A new toxin - antitoxin system"
"AaeAB efflux system for hydroxylated, aromatic carboxylic acids"	"AaeAB efflux system for hydroxylated, aromatic carboxylic acids"
"ABC transporter of unknown substrate X"	"ABC transporter of unknown substrate X"
"ABC transporter tungstate (TC 3.A.1.6.2)"	"ABC transporter tungstate (TC 3.A.1.6.2)"
"ABC transporter YeiABEF"	"ABC transporter YeiABEF"
"ABC transporter YxeMNO"	"ABC transporter YxeMNO"
"ABC-type iron transport system"	"ABC-type iron transport system"
"Accessory colonization factor"	"Accessory colonization factor"
"Acetoin, butanediol metabolism"	"Acetolactate synthase subunits!Acetoin, butanediol metabolism!Branched-Chain Amino Acid Biosynthesis"
"Acetolactate synthase subunits"	"Acetolactate synthase subunits!Acetoin, butanediol metabolism!Branched-Chain Amino Acid Biosynthesis"
"Acetone carboxylase"	"Acetone carboxylase"
"Acetophenone carboxylase 1"	"Anaerobic toluene and ethylbenzene degradation!Acetophenone carboxylase 1"
"Acetyl-CoA Pathway Wood-Ljungdahl"	"Acetyl-CoA Pathway Wood-Ljungdahl"
"Actinobacterial signal transduction system MtrAB-LpqB"	"Actinobacterial signal transduction system MtrAB-LpqB"
"Activation of fatty acids as acyl-adenylates cluster subgroup FadD10"	"Activation of fatty acids as acyl-adenylates cluster subgroup FadD10"
"Acyclic terpene utilization"	"Acyclic terpene utilization"
"Acyl carrier protein"	"Fatty acid synthesis!Fatty Acid Biosynthesis FASII!Enoyl-[ACP] reductases disambiguation!Fatty Acid Biosynthesis cluster!Acyl carrier protein!Resistance to Triclosan"
"Acyl-CoA thioesterase II"	"Acyl-CoA thioesterase II"
"Adaptation to d-cysteine"	"Adaptation to d-cysteine"
"Adenosyl nucleosidases"	"Adenosyl nucleosidases"
"Adenylylsulfate reductase"	"Adenylylsulfate reductase"
"Adhesins in Staphylococcus"	"Adhesins in Staphylococcus"
"Aerotolerance operon"	"Aerotolerance operon"
"Agrobacterium opine transport"	"Agrobacterium opine transport"
"Agrocinopine utilization"	"Agrocinopine utilization"
"Alginate biosynthesis"	"Alginate biosynthesis"
"Alkane biosynthesis in bacteria"	"Alkane biosynthesis in bacteria"
"Alkane synthesis in bacteria 2"	"Alkane synthesis in bacteria 2!Head-to-head olefinic hydrocarbon biosynthesis!Polyunsaturated Fatty Acids synthesis"
"Alpha-acetolactate operon"	"Alpha-acetolactate operon"
"alpha-glucoside ABC transporter"	"alpha-glucoside ABC transporter"
"Amidase clustered with urea and nitrile hydratase functions"	"Amidase clustered with urea and nitrile hydratase functions"
"Amino acid racemase"	"Amino acid racemase"
"Aminoglycoside modifying enzymes: N-acetyltransferases"	"Aminoglycoside modifying enzymes: N-acetyltransferases"
"Aminoglycoside modifying enzymes: O-nucleotidyltransferases"	"Aminoglycoside modifying enzymes: O-nucleotidyltransferases"
"Aminoglycoside modifying enzymes: O-phosphotransferases"	"Aminoglycoside modifying enzymes: O-phosphotransferases"
"AMP to 3-phosphoglycerate"	"AMP to 3-phosphoglycerate"
"An Arabinose Sensor"	"An Arabinose Sensor"
"Anaerobic dimethyl sulfoxide reductase (EC 1.8.5.3)"	"Anaerobic dimethyl sulfoxide reductase (EC 1.8.5.3)"
"Anaerobic glycerol-3-phosphate dehydrogenase subunits"	"Anaerobic glycerol-3-phosphate dehydrogenase subunits"
"Anaerobic module of TCA"	"Anaerobic module of TCA"
"Anaerobic Oxidative Degradation of L-Ornithine"	"Anaerobic Oxidative Degradation of L-Ornithine"
"Anaerobic respiratory complex QmoABC"	"Anaerobic respiratory complex QmoABC"
"Anaerobic toluene and ethylbenzene degradation"	"Anaerobic toluene and ethylbenzene degradation!Acetophenone carboxylase 1"
"Anthrose Biosynthesis"	"Anthrose Biosynthesis"
"Antibiotic anticapsin - bacilysin"	"Antibiotic anticapsin - bacilysin"
"Antibiotic targets in cell wall biosynthesis"	"Antibiotic targets in cell wall biosynthesis"
"Antibiotic targets in DNA processing"	"Antibiotic targets in DNA processing!DNA topoisomerases, Type II, ATP-dependent"
"Antibiotic targets in metabolic pathways"	"Antibiotic targets in metabolic pathways"
"Antibiotic targets in protein synthesis"	"Antibiotic targets in protein synthesis"
"Antibiotic targets in transcription"	"Antibiotic targets in transcription"
"Archaeal membrane bound hydrogenases"	"Archaeal membrane bound hydrogenases!Mebrane bound hydrogenases!Energy conserving hydrogenase, Methanococcales-Methanobacteriales-Methanopyrales!Energy conserving hydrogenase b, Methanococcales-Methanobacteriales-Methanopyrales"
"Archease"	"Archease"
"Fusidic acid resistance"	"Fusidic acid resistance"
"Forespore to mother cell channel"	"Forespore to mother cell channel"
"Bacteriocin resistance related cluster"	"Bacteriocin resistance related cluster"
"Arginine biosynthesis via N-acetyl-L-citrulline"	"Arginine biosynthesis via N-acetyl-L-citrulline!Arginine biosynthesis"
"Arginine biosynthesis"	"Arginine biosynthesis via N-acetyl-L-citrulline!Arginine biosynthesis"
"Arginine decarboxylase and Agmatinase cluster"	"Arginine decarboxylase and Agmatinase cluster"
"Arginine succinyltransferase pathway"	"Arginine succinyltransferase pathway"
"Aromatic amino acid interconversions with aryl acids"	"Indole-pyruvate oxidoreductase complex!Aromatic amino acid interconversions with aryl acids"
"Arsenic resistance"	"Arsenic resistance"
"Aspartate to Homoserine module"	"Aspartate to Homoserine module!Aspartate to Threonine Module"
"Aspartate to Threonine Module"	"Aspartate to Homoserine module!Aspartate to Threonine Module"
"ATP-dependent Nuclease"	"DNA repair, bacterial RecBCD pathway!ATP-dependent Nuclease"
"ATP-dependent RNA helicases, bacterial"	"ATP-dependent RNA helicases, bacterial"
"AttEFGH ABC Transport System"	"AttEFGH ABC Transport System"
"Autoinducer 2 (AI-2) transport and processing (lsrACDBFGE operon)"	"Autoinducer 2 (AI-2) transport and processing (lsrACDBFGE operon)"
"Bacillibactin Siderophore"	"Bacillibactin Siderophore"
"Bacillithiol synthesis"	"Bacillithiol synthesis"
"Bacillus cannibalism system"	"Bacillus cannibalism system"
"Bacillus subtilis yydFGHIJ operon"	"Bacillus subtilis yydFGHIJ operon"
"Bacitracin resistance"	"Bacitracin resistance"
"Bacterial cell division related cluster 2"	"Bacterial cell division related cluster 2"
"Bacterial checkpoint-control-related cluster"	"Bacterial checkpoint-control-related cluster"
"Bacterial light-harvesting proteins"	"Bacterial light-harvesting proteins"
"Bacterial pathways for dimethylsulfoniopropionate and acrylate catabolism"	"Bacterial pathways for dimethylsulfoniopropionate and acrylate catabolism"
"Bacterial Sphingolipids"	"Bacterial Sphingolipids"
"Bacteroides capsular polysaccharide transcription antitermination proteins"	"Bacteroides capsular polysaccharide transcription antitermination proteins"
"BactLuciferaseComplex"	"BactLuciferaseComplex"
"BarA-UvrY(SirA) two-component regulatory system"	"BarA-UvrY(SirA) two-component regulatory system"
"Barnase-barstar complex"	"Barnase-barstar complex"
"Benzoyl-CoA pathway of anaerobic aromatic metabolism"	"Benzoyl-CoA pathway of anaerobic aromatic metabolism"
"beta-Barrel Assembly Machinery"	"beta-Barrel Assembly Machinery"
"Beta-lactamases Ambler class A"	"Beta-lactamases Ambler class A"
"Beta-lactamases Ambler class B"	"Beta-lactamases Ambler class B"
"Beta-lactamases Ambler class C"	"Beta-lactamases Ambler class C"
"Beta-lactamases Ambler class D"	"Beta-lactamases Ambler class D"
"Betaine biosynthesis from glycine"	"Betaine biosynthesis from glycine"
"Betaine lipids in bactera"	"Betaine lipids in bactera"
"Bicyclomycin resistance cluster"	"Bicyclomycin resistance cluster"
"Bile hydrolysis"	"Bile hydrolysis"
"Biofilm Adhesin Biosynthesis"	"Biofilm Adhesin Biosynthesis"
"Biofilm formation in Staphylococcus"	"Biofilm formation in Staphylococcus"
"Biogenesis of c-type cytochromes"	"Biogenesis of c-type cytochromes"
"Biogenesis of cbb3-type cytochrome c oxidases"	"Biogenesis of cbb3-type cytochrome c oxidases!Cytochrome c oxidase EC 1.9.3.1"
"Biogenesis of cytochrome c oxidases"	"Biogenesis of cytochrome c oxidases!Cytochrome bo ubiquinol oxidase!Heme O and Heme A biosynthesis!Heme O and Heme A biosynthesis (with selected terminal oxidases)"
"Biosynthesis of 4,4'-diapolycopene dialdehyde"	"Biosynthesis of 4,4'-diapolycopene dialdehyde"
"Biosynthesis of Arabinogalactan in Mycobacteria"	"Biosynthesis of Arabinogalactan in Mycobacteria"
"Biosynthesis of thiamin antivitamin Bacimethrin"	"Biosynthesis of thiamin antivitamin Bacimethrin"
"Biotin biosynthesis"	"Biotin biosynthesis"
"Biotin synthesis & utilization"	"Biotin synthesis & utilization"
"Biotin synthesis cluster"	"Biotin synthesis cluster"
"Box C-D RNA-guided RNA methyltransferase"	"Box C-D RNA-guided RNA methyltransferase"
"BOX elements in Streptococci"	"BOX elements in Streptococci"
"Branched-Chain Amino Acid Biosynthesis"	"Acetolactate synthase subunits!Acetoin, butanediol metabolism!Branched-Chain Amino Acid Biosynthesis"
"Branched-chain amino acids and alpha-keto acids utilization as energy sources"	"Branched-chain amino acids and alpha-keto acids utilization as energy sources!Butyrate kinase pathway"
"BtuS-PduT gene cluster for metalloporphyrine salvage"	"BtuS-PduT gene cluster for metalloporphyrine salvage"
"Butyrate kinase pathway"	"Branched-chain amino acids and alpha-keto acids utilization as energy sources!Butyrate kinase pathway"
"Cadmium resistance"	"Cadmium resistance"
"Calvin-Benson cycle"	"Calvin-Benson cycle"
"Carbon monoxide induced hydrogenase"	"Carbon monoxide induced hydrogenase"
"Carbon storage regulator"	"Carbon storage regulator"
"Carbonic anhydrase"	"Carbonic anhydrase"
"Carboxysome"	"Carboxysome"
"Cardiolipin biosynthesis"	"Cardiolipin biosynthesis"
"Carnitine metabolism and transport"	"Carnitine operon!Carnitine metabolism and transport"
"Carnitine operon"	"Carnitine operon!Carnitine metabolism and transport"
"Carotenogenesis related cluster"	"Carotenogenesis related cluster"
"Cell division cluster"	"Cell division cluster"
"Cell division initiation related cluster"	"Cell division initiation related cluster"
"Cell division related cluster"	"Cell division related cluster"
"Cell division related cluster including coaD"	"Cell division related cluster including coaD"
"Cell envelope-associated LytR-CpsA-Psr transcriptional attenuators"	"Cell envelope-associated LytR-CpsA-Psr transcriptional attenuators"
"Cell invasion-related virulence operon MCE"	"Cell invasion-related virulence operon MCE"
"Cell wall-associated cluster in Mycobacterium"	"Cell wall-associated cluster in Mycobacterium"
"Chaperones GroEL GroES and Thermosome"	"Chaperones GroEL GroES and Thermosome"
"Chemotaxis in Escherichia coli and Bacillus subtilis"	"Chemotaxis in Escherichia coli and Bacillus subtilis"
"Chitobiose"	"Chitobiose"
"Chloramphenicol resistance"	"Chloramphenicol resistance"
"Chlorophyll a synthase and phytol kinase cluster"	"Chlorophyll a synthase and phytol kinase cluster"
"Chlorophyll Biosynthesis in plants and prokaryotes"	"Chlorophyll Biosynthesis in plants and prokaryotes"
"Chlorophyll Degradation"	"Chlorophyll Degradation"
"Chlorosome"	"Chlorosome"
"Cholera toxin"	"Cholera toxin"
"Cholesterol catabolism"	"Cholesterol catabolism"
"Choline uptake and conversion to betaine clusters"	"Glycine betaine synthesis from choline!Choline uptake and conversion to betaine clusters"
"Chorismate Synthesis"	"Chorismate Synthesis"
"Citrate lyase"	"Citrate lyase"
"Citrate uptake cluster"	"Citrate uptake cluster"
"Cluster containing Glutathione synthetase"	"Cluster containing Glutathione synthetase"
"Cluster related to 2-thiouridine modification of tRNAs"	"Cluster related to 2-thiouridine modification of tRNAs"
"Cluster related to PAS - para-aminosalicylic acid resistance"	"Cluster related to PAS - para-aminosalicylic acid resistance"
"CMP-legionaminic acid synthesis"	"CMP-legionaminic acid synthesis"
"CMP-pseudaminic acid synthesis"	"CMP-pseudaminic acid synthesis"
"CoA disulfide thiol-disulfide redox system"	"CoA disulfide thiol-disulfide redox system"
"Coat proteins CotJABC"	"Coat proteins CotJABC"
"Cob(I)alamin adenosyltransferase"	"Cob(I)alamin adenosyltransferase"
"Cobalamin synthesis"	"Cobalamin synthesis!Cobalamin synthesis, Precorin-2 to Cob(II)yrinate a,c diamide, anaerobic!Cobalamin synthesis from Cob(II)yrinate a,c diamide"
"Cobalamin synthesis from Cob(II)yrinate a,c diamide"	"Cobalamin synthesis!Cobalamin synthesis, Precorin-2 to Cob(II)yrinate a,c diamide, anaerobic!Cobalamin synthesis from Cob(II)yrinate a,c diamide"
"Cobalamin synthesis, Precorin-2 to Cob(II)yrinate a,c diamide, aerobic"	"Cobalamin synthesis, Precorin-2 to Cob(II)yrinate a,c diamide, aerobic"
"Cobalamin synthesis, Precorin-2 to Cob(II)yrinate a,c diamide, anaerobic"	"Cobalamin synthesis!Cobalamin synthesis, Precorin-2 to Cob(II)yrinate a,c diamide, anaerobic!Cobalamin synthesis from Cob(II)yrinate a,c diamide"
"Coenzyme A"	"Coenzyme A!Coenzyme A -- gjo"
"Coenzyme A -- gjo"	"Coenzyme A!Coenzyme A -- gjo"
"Coenzyme A Biosynthesis cluster"	"Coenzyme A Biosynthesis cluster"
"Coenzyme B synthesis"	"Coenzyme B synthesis"
"Coenzyme F420 hydrogenase"	"Coenzyme F420 hydrogenase"
"Coenzyme F420 synthesis"	"Coenzyme F420 synthesis"
"Coenzyme F420-H2 dehydrogenase (methanophenazine)"	"Coenzyme F420-H2 dehydrogenase (methanophenazine)"
"Coenzyme PQQ synthesis"	"Coenzyme PQQ synthesis!Pyrroloquinoline Quinone biosynthesis"
"Colanic acid synthesis"	"Colanic acid synthesis"
"Cold shock proteins of CSP family"	"Cold shock proteins of CSP family"
"Colicin V and Bacteriocin Production Cluster"	"Colicin V and Bacteriocin Production Cluster"
"Conjugative transfer"	"Conjugative transfer"
"Conjugative transposon, Bacteroidales"	"Conjugative transposon, Bacteroidales"
"Control of cell elongation - division cycle in Bacilli"	"Control of cell elongation - division cycle in Bacilli"
"Copper homeostasis: copper tolerance"	"Copper homeostasis: copper tolerance"
"Copper transport and blue copper proteins"	"Copper transport and blue copper proteins"
"Copper Transport System"	"Copper Transport System!Copper uptake system CopCD"
"Copper uptake system CopCD"	"Copper Transport System!Copper uptake system CopCD"
"CtsR and MscAB regulation of protein degradation"	"CtsR and MscAB regulation of protein degradation"
"Cyanate hydrolysis"	"Cyanate hydrolysis"
"Cyanobacterial bypass in the TCA"	"Cyanobacterial bypass in the TCA"
"Cyanophycin Metabolism"	"Cyanophycin Metabolism"
"Cyclic Di-GMP Turnover Proteins"	"Cyclic Di-GMP Turnover Proteins!Oxygen-sensing diguanylate cyclase and phosphodiesterase couple for c-di-GMP control"
"Cysteine dioxygenase containing cluster 1"	"Cysteine dioxygenase containing cluster 1"
"Cysteine synthesis"	"Cysteine synthesis"
"Cytochrome b6-f complex in plants (plastidial) and cyanobacteria"	"Cytochrome b6-f complex in plants (plastidial) and cyanobacteria"
"Cytochrome bo ubiquinol oxidase"	"Biogenesis of cytochrome c oxidases!Cytochrome bo ubiquinol oxidase!Heme O and Heme A biosynthesis!Heme O and Heme A biosynthesis (with selected terminal oxidases)"
"Cytochrome c oxidase EC 1.9.3.1"	"Biogenesis of cbb3-type cytochrome c oxidases!Cytochrome c oxidase EC 1.9.3.1"
"Cytochrome d ubiquinol oxidase operon"	"Cytochrome d ubiquinol oxidase operon"
"Cytolethal distending toxins"	"Toxins!Pertussis toxin!Cytolethal distending toxins"
"Cytolysin and Lipase operon in Vibrio"	"Cytolysin and Lipase operon in Vibrio"
"CytR regulation"	"CytR regulation"
"D-3-phosphoglycerate to phosphoserine module"	"D-3-phosphoglycerate to phosphoserine module"
"D-alanylation of teichoic acid"	"D-alanylation of teichoic acid"
"D-allose utilzation"	"D-allose utilzation"
"D-altritol utilization"	"D-altritol utilization"
"D-arabinitol utilization"	"D-arabinitol utilization"
"D-arabinose utilization"	"D-arabinose utilization"
"D-Galacturonate and D-Glucuronate Utilization"	"D-Galacturonate and D-Glucuronate Utilization"
"D-galacturonate utilization, oxidative pathway"	"D-galacturonate utilization, oxidative pathway"
"D-gluconate and ketogluconates metabolism"	"D-gluconate and ketogluconates metabolism"
"D-glucosaminate utilization"	"D-glucosaminate utilization"
"D-threonate, L-threonate and D-erythronate utilization"	"D-threonate, L-threonate and D-erythronate utilization"
"D-tyrosyl-tRNA(Tyr) deacylase"	"D-tyrosyl-tRNA(Tyr) deacylase!tRNA aminoacylation, Tyr"
"D-xylose utilization"	"D-xylose utilization"
"Damaged nicotinamide nucleotide NAD(P)HX repair"	"Damaged nicotinamide nucleotide NAD(P)HX repair"
"DAP (1,3-diaminopropane) production"	"DAP (1,3-diaminopropane) production"
"De Novo Pyrimidine Synthesis"	"De Novo Pyrimidine Synthesis"
"Degradation of branched-chain amino acids and alpha-keto acids [Leu, Val]"	"Degradation of branched-chain amino acids and alpha-keto acids [Leu, Val]"
"Dehydrogenase complexes"	"Dehydrogenase complexes"
"Delta(6)-desaturase containing cluster"	"Delta(6)-desaturase containing cluster"
"Denitrifying reductase gene clusters"	"Denitrifying reductase gene clusters"
"DeNovo Purine Biosynthesis"	"DeNovo Purine Biosynthesis"
"Desulfovibrio high-molecular-weight cytochrome cluster"	"Desulfovibrio high-molecular-weight cytochrome cluster"
"DevBCA efflux pump transporter (of ABC type) cyanobacterial"	"DevBCA efflux pump transporter (of ABC type) cyanobacterial"
"Diaminopimelate Synthesis"	"Diaminopimelate Synthesis!Lysine DAP biosynthetic pathway"
"Dihydropyrimidine dehydrogenase"	"Dihydropyrimidine dehydrogenase!Uridine to beta-Alanine and Thymine to 3-aminoisobutanoate module"
"Dihydroxyacetone kinases"	"Dihydroxyacetone kinases"
"Dimethylsulfide dehydrogenase"	"Dimethylsulfide dehydrogenase"
"Dioxygenolytic carbon monoxide-forming enzymes"	"Dioxygenolytic carbon monoxide-forming enzymes"
"Diphthamide biosynthesis"	"Diphthamide biosynthesis"
"Diphtheria toxin"	"Diphtheria toxin"
"Dipicolinate Synthesis"	"Peptidase clustering with DAP!Dipicolinate Synthesis"
"Dissimilatory nitrite reductase"	"Dissimilatory nitrite reductase"
"DNA Helicase of Unknown Function"	"DNA Helicase of Unknown Function"
"DNA internalization-related cluster"	"DNA internalization-related cluster"
"DNA phosphorothioation-dependent restriction system DptFGH"	"DNA phosphorothioation-dependent restriction system DptFGH"
"DNA processing cluster"	"DNA processing cluster"
"DNA recombination, archaeal"	"DNA recombination, archaeal"
"DNA Repair Base Excision"	"DNA Repair Base Excision"
"DNA repair system including RecA, MutS and a hypothetical protein"	"DNA repair system including RecA, MutS and a hypothetical protein!RecA and RecX"
"DNA repair, bacterial"	"DNA repair, bacterial"
"DNA repair, bacterial DinG and relatives"	"DNA repair, bacterial DinG and relatives"
"DNA repair, bacterial MutHLS system"	"DNA repair, bacterial MutHLS system"
"DNA repair, bacterial photolyase"	"DNA repair, bacterial photolyase"
"DNA repair, bacterial RecBCD pathway"	"DNA repair, bacterial RecBCD pathway!ATP-dependent Nuclease"
"DNA repair, bacterial RecFOR pathway"	"DNA repair, bacterial RecFOR pathway"
"DNA repair, bacterial SbcCD exonuclease"	"DNA repair, bacterial SbcCD exonuclease"
"DNA repair, bacterial UmuCD system"	"DNA repair, bacterial UmuCD system"
"DNA repair, bacterial UvrD and related helicases"	"DNA repair, bacterial UvrD and related helicases"
"DNA repair, UvrABC system"	"DNA repair, UvrABC system"
"DNA sulfur modification cluster"	"DNA sulfur modification cluster"
"DNA topoisomerases, Type II, ATP-dependent"	"Antibiotic targets in DNA processing!DNA topoisomerases, Type II, ATP-dependent"
"Dpp dipeptide ABC transport system"	"Dpp dipeptide ABC transport system!Glutathione ABC transporter"
"dTDP-3-acetamido-3,6-dideoxy-alpha-D-galactose synthesis"	"dTDP-3-acetamido-3,6-dideoxy-alpha-D-galactose synthesis"
"dTDP-rhamnose synthesis"	"dTDP-rhamnose synthesis!dTDP-rhamnose synthesis -- gjo"
"dTDP-rhamnose synthesis -- gjo"	"dTDP-rhamnose synthesis!dTDP-rhamnose synthesis -- gjo"
"EcsAB transporter affecting expression and secretion of secretory preproteins"	"EcsAB transporter affecting expression and secretion of secretory preproteins"
"Ectoine synthesis"	"Ectoine synthesis"
"Ectoine, hydroxyectoine uptake and catabolism"	"Ectoine, hydroxyectoine uptake and catabolism"
"Efflux ABC transporter MdlAB"	"Efflux ABC transporter MdlAB"
"Efflux ABC transporter YadGH"	"Efflux ABC transporter YadGH"
"Efflux ABC transporters BmrCD and LmrCD involved in multidrug resistance"	"Efflux ABC transporters BmrCD and LmrCD involved in multidrug resistance"
"Electron-bifurcating caffeyl-CoA reductase-Etf complex"	"Electron-bifurcating caffeyl-CoA reductase-Etf complex"
"Encapsulation of DyP-type peroxidase or ferritin-like protein oligomers"	"Encapsulation of DyP-type peroxidase or ferritin-like protein oligomers"
"Energy conserving hydrogenase b, Methanococcales-Methanobacteriales-Methanopyrales"	"Archaeal membrane bound hydrogenases!Mebrane bound hydrogenases!Energy conserving hydrogenase, Methanococcales-Methanobacteriales-Methanopyrales!Energy conserving hydrogenase b, Methanococcales-Methanobacteriales-Methanopyrales"
"Energy conserving hydrogenase, Methanococcales-Methanobacteriales-Methanopyrales"	"Archaeal membrane bound hydrogenases!Mebrane bound hydrogenases!Energy conserving hydrogenase, Methanococcales-Methanobacteriales-Methanopyrales!Energy conserving hydrogenase b, Methanococcales-Methanobacteriales-Methanopyrales"
"Energy-conserving hydrogenase (ferredoxin)"	"Energy-conserving hydrogenase (ferredoxin)"
"Enoyl-[ACP] reductases disambiguation"	"Fatty acid synthesis!Fatty Acid Biosynthesis FASII!Enoyl-[ACP] reductases disambiguation!Fatty Acid Biosynthesis cluster!Acyl carrier protein!Resistance to Triclosan"
"Enterobacterial common antigen (LPS O-antigen)"	"Enterobacterial common antigen (LPS O-antigen)"
"Entner-Doudoroff Pathway"	"Entner-Doudoroff Pathway"
"EnvZ and OmpR regulon"	"EnvZ and OmpR regulon"
"Ergothioneine biosynthesis"	"Ergothioneine biosynthesis"
"ESAT-6 protein secretion system in Mycobacteria (locus ESX-5)"	"ESAT-6 protein secretion system in Mycobacteria (locus ESX-5)"
"ESAT-6 proteins secretion system in Firmicutes and Actinobacteria"	"ESAT-6 proteins secretion system in Firmicutes and Actinobacteria"
"ESAT-6 proteins secretion system in Firmicutes extended"	"ESAT-6 proteins secretion system in Firmicutes extended"
"ESAT-6 proteins secretion system in Mycobacteria (locus ESX-1)"	"ESAT-6 proteins secretion system in Mycobacteria (locus ESX-1)"
"ESAT-6 proteins secretion system in Mycobacteria (locus ESX-2)"	"ESAT-6 proteins secretion system in Mycobacteria (locus ESX-2)"
"ESAT-6 proteins secretion system in Mycobacteria (locus ESX-3)"	"ESAT-6 proteins secretion system in Mycobacteria (locus ESX-3)"
"ESAT-6 proteins secretion system in Mycobacteria (locus ESX-4)"	"ESAT-6 proteins secretion system in Mycobacteria (locus ESX-4)"
"Ethanolamine utilization"	"Ethanolamine utilization"
"Ethylmalonyl-CoA pathway of C2 assimilation"	"Ethylmalonyl-CoA pathway of C2 assimilation"
"Exosome"	"Exosome"
"Exosporium"	"Exosporium"
"Extracellular matrix proteins (PEL) involved in glucose-rich biofilm formation in Pseudomonas"	"Extracellular matrix proteins (PEL) involved in glucose-rich biofilm formation in Pseudomonas"
"Extracellular matrix proteins (PSL) involved in mannose-rich biofilm formation in Pseudomonas"	"Extracellular matrix proteins (PSL) involved in mannose-rich biofilm formation in Pseudomonas"
"F0F1-type ATP synthase"	"F0F1-type ATP synthase"
"Fatty Acid Biosynthesis cluster"	"Fatty acid synthesis!Fatty Acid Biosynthesis FASII!Enoyl-[ACP] reductases disambiguation!Fatty Acid Biosynthesis cluster!Acyl carrier protein!Resistance to Triclosan"
"Fatty Acid Biosynthesis FASII"	"Fatty acid synthesis!Fatty Acid Biosynthesis FASII!Enoyl-[ACP] reductases disambiguation!Fatty Acid Biosynthesis cluster!Acyl carrier protein!Resistance to Triclosan"
"Fatty acid catabolic operon fadN-fadA-fadE (yusJKL)"	"Fatty acid catabolic operon fadN-fadA-fadE (yusJKL)"
"Fatty acid degradation"	"Fatty acid degradation"
"Fatty acid metabolism cluster"	"Fatty acid metabolism cluster"
"Fatty acid synthesis"	"Fatty acid synthesis!Fatty Acid Biosynthesis FASII!Enoyl-[ACP] reductases disambiguation!Fatty Acid Biosynthesis cluster!Acyl carrier protein!Resistance to Triclosan"
"Fe-S cluster assembly"	"Fe-S cluster assembly"
"Fe(III) respiration - Shewanella type"	"Fe(III) respiration - Shewanella type!Respiratory Systems - Shewanella (updated)"
"Fermentations: Lactate"	"Fermentations: Lactate"
"Fermentations: Mixed acid"	"Fermentations: Mixed acid"
"Ferrous iron transporter EfeUOB, low-pH-induced"	"Ferrous iron transporter EfeUOB, low-pH-induced"
"Fet iron export system"	"Fet iron export system"
"Flagellum"	"Flagellum"
"Folate Biosynthesis"	"Folate Biosynthesis"
"Folate biosynthesis cluster"	"Folate biosynthesis cluster"
"Formaldehyde assimilation: Ribulose monophosphate pathway"	"Formaldehyde assimilation: Ribulose monophosphate pathway"
"Formate dehydrogenase"	"Formate dehydrogenase"
"Fosfomycin resistance"	"Fosfomycin resistance"
"Fructoselysine and glucoselysine"	"Fructoselysine and glucoselysine"
"FtsEX cell-division-associated signaling system"	"FtsEX cell-division-associated signaling system"
"Fusaric acid resistance cluster"	"Fusaric acid resistance cluster"
"G-protein-coupled receptor (GPCR) system in Actinobacteria"	"Prenylated indole derivatives in actinomycetes!G-protein-coupled receptor (GPCR) system in Actinobacteria"
"Galactosamine Substituent of Arabinogalactan in Mycobacteria"	"Galactosamine Substituent of Arabinogalactan in Mycobacteria"
"Galactose utilization"	"Galactose utilization"
"Gallic acid utilization"	"Gallic acid utilization"
"GDP-fucose to mannose-1P module"	"GDP-fucose to mannose-1P module"
"Gene Transfer Agent"	"Gene Transfer Agent"
"General Secretion Pathway"	"General Secretion Pathway"
"Gentisate pathway"	"Gentisate pathway"
"GlrKR two-component regulatory system"	"GlrKR two-component regulatory system"
"Glutaconate CoA-transferase or 3-oxoadipate CoA-transferase Subunits"	"Glutaconate CoA-transferase or 3-oxoadipate CoA-transferase Subunits"
"Glutamate dehydrogenases"	"Glutamate dehydrogenases"
"Glutamate fermentation"	"Glutamate fermentation"
"Glutamine synthetases"	"Glutamine synthetases"
"Glutathione ABC transporter"	"Dpp dipeptide ABC transport system!Glutathione ABC transporter"
"Glutathione analogs: mycothiol"	"Glutathione analogs: mycothiol"
"Glutathione-dependent pathway of formaldehyde detoxification"	"Glutathione-dependent pathway of formaldehyde detoxification"
"Glutathione: Biosynthesis and gamma-glutamyl cycle"	"Glutathione: Biosynthesis and gamma-glutamyl cycle!Methylhydantoinase"
"Glutathione: Non-redox reactions"	"Glutathione: Non-redox reactions"
"Glutathione: Redox cycle"	"Glutathione: Redox cycle"
"Glutathionylspermidine and Trypanothione"	"Glutathionylspermidine and Trypanothione"
"Glycerol ABC transporter"	"Glycerol ABC transporter!Glycerol utilization cluster"
"Glycerol fermentation to 1,3-propanediol"	"Glycerol fermentation to 1,3-propanediol"
"Glycerol utilization cluster"	"Glycerol ABC transporter!Glycerol utilization cluster"
"Glycerolipid and Glycerophospholipid Metabolism in Bacteria"	"Glycerolipid and Glycerophospholipid Metabolism in Bacteria"
"Glycine betaine synthesis from choline"	"Glycine betaine synthesis from choline!Choline uptake and conversion to betaine clusters"
"Glycine cleavage system"	"Glycine cleavage system"
"Glycine reductase, sarcosine reductase and betaine reductase"	"Glycine reductase, sarcosine reductase and betaine reductase"
"Glycogen metabolism"	"Glycogen metabolism"
"Glycolate, glyoxylate interconversions"	"Glycolate, glyoxylate interconversions"
"Glycolysis and Gluconeogenesis"	"Glycolysis and Gluconeogenesis, including Archaeal enzymes!Glycolysis and Gluconeogenesis"
"Glycolysis and Gluconeogenesis, including Archaeal enzymes"	"Glycolysis and Gluconeogenesis, including Archaeal enzymes!Glycolysis and Gluconeogenesis"
"Glycyl-tRNA synthetase"	"tRNA aminoacylation, Gly!Glycyl-tRNA synthetase"
"Glyoxylate bypass"	"Glyoxylate bypass"
"GMP synthase"	"GMP synthase"
"Gram-negative cluster"	"Gram-negative cluster"
"H2:CoM-S-S-HTP oxidoreductase"	"H2:CoM-S-S-HTP oxidoreductase"
"Head-to-head olefinic hydrocarbon biosynthesis"	"Alkane synthesis in bacteria 2!Head-to-head olefinic hydrocarbon biosynthesis!Polyunsaturated Fatty Acids synthesis"
"Heat shock dnaK gene cluster extended"	"Heat shock dnaK gene cluster extended"
"Heme and heme d1 biosynthesis from siroheme"	"Metal chelatases!Heme Biosynthesis: protoporphyrin-, coproporphyrin- and siroheme-dependent pathways!Heme and heme d1 biosynthesis from siroheme"
"Heme Biosynthesis: protoporphyrin-, coproporphyrin- and siroheme-dependent pathways"	"Metal chelatases!Heme Biosynthesis: protoporphyrin-, coproporphyrin- and siroheme-dependent pathways!Heme and heme d1 biosynthesis from siroheme"
"Heme O and Heme A biosynthesis"	"Biogenesis of cytochrome c oxidases!Cytochrome bo ubiquinol oxidase!Heme O and Heme A biosynthesis!Heme O and Heme A biosynthesis (with selected terminal oxidases)"
"Heme O and Heme A biosynthesis (with selected terminal oxidases)"	"Biogenesis of cytochrome c oxidases!Cytochrome bo ubiquinol oxidase!Heme O and Heme A biosynthesis!Heme O and Heme A biosynthesis (with selected terminal oxidases)"
"Heme, hemin uptake and utilization systems in GramPositives"	"Heme, hemin uptake and utilization systems in GramPositives"
"Heterocyst formation in cyanobacteria"	"Heterocyst formation in cyanobacteria"
"Hexose phosphate transport system"	"Hexose phosphate transport system"
"Hfl operon"	"Hfl operon"
"High affinity phosphate transporter and control of PHO regulon"	"High affinity phosphate transporter and control of PHO regulon"
"HipAB system implicated in growth arrest, persistence and drug tolerance"	"HipAB system implicated in growth arrest, persistence and drug tolerance"
"Histidine Biosynthesis"	"Histidine Biosynthesis!Histidine Biosynthesis -- gjo"
"Histidine Biosynthesis -- gjo"	"Histidine Biosynthesis!Histidine Biosynthesis -- gjo"
"Histidine Degradation"	"Histidine Degradation"
"HMG CoA Synthesis"	"HMG CoA Synthesis"
"Homogentisate pathway"	"Homogentisate pathway"
"Homoprotocatechuate degradative cluster"	"Homoprotocatechuate degradative cluster"
"Hopanoid biosynthesis"	"Hopanoid biosynthesis"
"HPr catabolite repression system"	"HPr catabolite repression system"
"HU-alpha and dsDNA mimic protein interaction"	"HU-alpha and dsDNA mimic protein interaction"
"Hyaluronate utilization"	"Hyaluronate utilization"
"Hyaluronic Acid-containing Cell Walls"	"Hyaluronic Acid-containing Cell Walls!Streptococcal Hyaluronic Acid Capsule"
"Hydrogen-sensing hydrogenase system"	"Hydrogen-sensing hydrogenase system"
"Hydrolysis of sphingomyelin"	"Hydrolysis of sphingomyelin"
"Hydroxy-fatty acid production as stress response"	"Hydroxy-fatty acid production as stress response"
"Hydroxyaromatic decarboxylase family"	"Hydroxyaromatic decarboxylase family"
"Hyperosmotic potassium uptake"	"Trk and Ktr potassium uptake systems!Hyperosmotic potassium uptake"
"IbrA and IbrB: co-activators of prophage gene expression"	"IbrA and IbrB: co-activators of prophage gene expression"
"IMP and Xanthine conversion to XMP and GMP module"	"IMP and Xanthine conversion to XMP and GMP module"
"Inclusion membrane proteins supporting intracellular life styles in Chlamydiales"	"Inclusion membrane proteins supporting intracellular life styles in Chlamydiales"
"Indole-pyruvate oxidoreductase complex"	"Indole-pyruvate oxidoreductase complex!Aromatic amino acid interconversions with aryl acids"
"Indoleacetamide metabolism"	"Indoleacetamide metabolism"
"Inner membrane proteins of MarC family, not involved in antibiotic resistance"	"Inner membrane proteins of MarC family, not involved in antibiotic resistance"
"Inositol catabolism"	"Inositol catabolism"
"Inositol-containing phospholipids"	"Inositol-containing phospholipids"
"Integrons"	"Integrons"
"Iron acquisition in Streptococcus"	"Iron acquisition in Streptococcus"
"Iron Scavenging cluster in Thermus"	"Iron Scavenging cluster in Thermus"
"Iron siderophore sensor & receptor system"	"Iron siderophore sensor & receptor system"
"Iron transport system including ABC transporter"	"Iron transport system including ABC transporter"
"Iron(III) dicitrate transport system Fec"	"Iron(III) dicitrate transport system Fec"
"Isoniazid inductible proteins cluster"	"Isoniazid inductible proteins cluster"
"Isoprenoid Biosynthesis: Interconversions"	"Isoprenoid Biosynthesis: Interconversions"
"KDO2-Lipid A biosynthesis"	"KDO2-Lipid A biosynthesis"
"L-2-amino-4-methoxy-trans-3-butenoic acid synthesis"	"L-2-amino-4-methoxy-trans-3-butenoic acid synthesis"
"L-2-amino-adipate to lysine module"	"Lysine Biosynthesis via alpha-aminoadipate AAA!LysX and ArgX disambiguation!L-2-amino-adipate to lysine module"
"L-Amino acid oxidases: lysine-epsilon oxidase LodA"	"L-Amino acid oxidases: lysine-epsilon oxidase LodA"
"L-ascorbate utilization (and related gene clusters)"	"L-ascorbate utilization (and related gene clusters)"
"L-fucose dissimilation cluster"	"L-fucose utilization!L-fucose dissimilation cluster"
"L-fucose utilization"	"L-fucose utilization!L-fucose dissimilation cluster"
"L-galactonate utilization"	"L-galactonate utilization"
"L-rhamnonate utilization cluster"	"L-rhamnonate utilization cluster"
"L-serine dehydratase subunits"	"L-serine dehydratase subunits!Pyruvate Alanine Serine Interconversions"
"Lactose utilization"	"Lactose utilization"
"Lambdoid phage"	"Lambdoid phage"
"Lasso peptide maturation cluster"	"Lasso peptide maturation cluster"
"Late competence"	"Late competence"
"Lipid orphans"	"Lipid orphans"
"Lipid orphans"	"Lipid orphans"
"Lipid-linked oligosaccharide synthesis related cluster"	"Lipid-linked oligosaccharide synthesis related cluster"
"Lipoic acid metabolism"	"Lipoic acid metabolism"
"Lipopolysaccharide in K12"	"Lipopolysaccharide in K12"
"Lipopolysaccharide transporter LptABC"	"Lipopolysaccharide transporter LptABC!Lpt lipopolysaccharide transport system!Ribosomal hibernation related cluster"
"Lipopolysaccharide-related cluster in Alphaproteobacteria"	"Lipopolysaccharide-related cluster in Alphaproteobacteria"
"Lipoprotein transporter to outer membrane Lol"	"Lipoprotein transporter to outer membrane Lol"
"Lipoylated proteins"	"TCA Cycle!2-oxoglutarate dehydrogenase!Lipoylated proteins"
"Lipoylation-related cluster"	"Lipoylation-related cluster"
"Listeria Pathogenicity Island LIPI-1 extended"	"Listeria Pathogenicity Island LIPI-1 extended"
"Listeria surface proteins: Internalin-like proteins"	"Listeria surface proteins: Internalin-like proteins"
"Lpt lipopolysaccharide transport system"	"Lipopolysaccharide transporter LptABC!Lpt lipopolysaccharide transport system!Ribosomal hibernation related cluster"
"Lysine Biosynthesis via alpha-aminoadipate AAA"	"Lysine Biosynthesis via alpha-aminoadipate AAA!LysX and ArgX disambiguation!L-2-amino-adipate to lysine module"
"Lysine DAP biosynthetic pathway"	"Diaminopimelate Synthesis!Lysine DAP biosynthetic pathway"
"Lysine fermentation"	"Lysine fermentation!Lysine fermentation to crotonoyl-CoA"
"Lysine fermentation to crotonoyl-CoA"	"Lysine fermentation!Lysine fermentation to crotonoyl-CoA"
"Lysine leader peptide"	"Lysine leader peptide"
"LysX and ArgX disambiguation"	"Lysine Biosynthesis via alpha-aminoadipate AAA!LysX and ArgX disambiguation!L-2-amino-adipate to lysine module"
"M. tuberculosis complex-specific locus aprABC, adaptation to phagosome"	"M. tuberculosis complex-specific locus aprABC, adaptation to phagosome"
"Macrolides, lincosamides, streptogramins, ketolides, oxazolidinones (MLSKO) resistance: efflux systems"	"Macrolides, lincosamides, streptogramins, ketolides, oxazolidinones (MLSKO) resistance: efflux systems"
"Macrolides, lincosamides, streptogramins, ketolides, oxazolidinones (MLSKO) resistance: enzymatic degradation"	"Macrolides, lincosamides, streptogramins, ketolides, oxazolidinones (MLSKO) resistance: enzymatic degradation"
"Macrolides, lincosamides, streptogramins, ketolides, oxazolidinones (MLSKO) resistance: ribosomal protection"	"Macrolides, lincosamides, streptogramins, ketolides, oxazolidinones (MLSKO) resistance: ribosomal protection"
"Macrolides, lincosamides, streptogramins, ketolides, oxazolidinones (MLSKO) resistance: rRNA methylases"	"Macrolides, lincosamides, streptogramins, ketolides, oxazolidinones (MLSKO) resistance: rRNA methylases"
"Macromolecular synthesis operon"	"Macromolecular synthesis operon"
"Magnesium transport"	"Magnesium transport"
"Maintenance of outer membrane lipid asymmetry"	"Maintenance of outer membrane lipid asymmetry"
"Malonate decarboxylase"	"Malonate decarboxylase"
"Mannosylglucosylglycerate synthesis"	"Mannosylglucosylglycerate synthesis"
"MazEF toxin-antitoxing (programmed cell death) system"	"MazEF toxin-antitoxing (programmed cell death) system"
"Mebrane bound hydrogenases"	"Archaeal membrane bound hydrogenases!Mebrane bound hydrogenases!Energy conserving hydrogenase, Methanococcales-Methanobacteriales-Methanopyrales!Energy conserving hydrogenase b, Methanococcales-Methanobacteriales-Methanopyrales"
"Mechanisms of PAS resistance"	"Mechanisms of PAS resistance"
"Membrane bound hydrogenase Mbh"	"Membrane bound hydrogenase Mbh"
"Menaquinone biosynthesis from chorismate via 1,4-dihydroxy-2-naphthoate"	"Menaquinone biosynthesis from chorismate via 1,4-dihydroxy-2-naphthoate"
"Menaquinone biosynthesis from chorismate via 1,4-dihydroxy-6-naphthoate"	"Menaquinone biosynthesis from chorismate via 1,4-dihydroxy-6-naphthoate"
"Metabolite repair"	"Metabolite repair"
"Metal chelatases"	"Metal chelatases!Heme Biosynthesis: protoporphyrin-, coproporphyrin- and siroheme-dependent pathways!Heme and heme d1 biosynthesis from siroheme"
"Methanofuran biosynthesis"	"Methanofuran biosynthesis"
"Methanogenesis"	"Methanogenesis"
"Methanogenesis from methylated compounds"	"Methanogenesis from methylated compounds"
"Methanophenazine hydrogenase"	"Methanophenazine hydrogenase"
"Methionine Salvage"	"Methionine Salvage"
"Methylenetetrahydrofolate reductase"	"Methylenetetrahydrofolate reductase"
"Methylglyoxal Metabolism"	"Methylglyoxal Metabolism"
"Methylglyoxal resistance in Bacillus subtilis"	"Methylglyoxal resistance in Bacillus subtilis"
"Methylhydantoinase"	"Glutathione: Biosynthesis and gamma-glutamyl cycle!Methylhydantoinase"
"Methylthiotransferases"	"Ribosomal protein S12p Asp methylthiotransferase!Methylthiotransferases"
"Mevalonate metabolic pathway"	"Mevalonate metabolic pathway"
"MexXY System of Pseudomonas aeruginosa"	"Tripartite multidrug efflux systems (of RND type) MdtABC-TolC!MexXY System of Pseudomonas aeruginosa!Tripartite multidrug efflux systems (of RND type) in Pseudomonas"
"Modification of eukaryotic initiation factor 5A"	"Modification of eukaryotic initiation factor 5A"
"Molybdenum cofactor biosynthesis"	"Molybdenum cofactor biosynthesis"
"Molybdopterin cytosine dinucleotide"	"Molybdopterin cytosine dinucleotide"
"mRNA 3-end processing factor containing cluster"	"mRNA 3-end processing factor containing cluster"
"Mu-like phage"	"Mu-like phage"
"Muconate lactonizing enzyme family"	"Muconate lactonizing enzyme family"
"MukBEF Chromosome Condensation"	"MukBEF Chromosome Condensation"
"Multi-subunit cation antiporter"	"Respiratory Complex I!NADH ubiquinone oxidoreductase!Multi-subunit cation antiporter!Respiratory complex I in plants (plastidial) and cyanobacteria!NADH ubiquinone oxidoreductase vs. multi-subunit cation antiporter"
"Multidrug resistance RND efflux system MexEFOprN"	"Multidrug resistance RND efflux system MexEFOprN"
"Multidrug Resistance, Tripartite Systems Found in Gram Negative Bacteria TEMP"	"Tripartite multidrug efflux systems (of MFS type) in Gram-negative bacteria!Multidrug Resistance, Tripartite Systems Found in Gram Negative Bacteria TEMP"
"Multiple Antibiotic Resistance MAR locus"	"Multiple Antibiotic Resistance MAR locus"
"Mupirocin resistance"	"Mupirocin resistance!tRNA aminoacylation, Ile"
"Murein hydrolase regulation and cell death"	"Murein hydrolase regulation and cell death"
"Mycobacterial cell wall virulence lipid phthiocerol dimycocerosate (PDIM)"	"Mycobacterial cell wall virulence lipid phthiocerol dimycocerosate (PDIM)"
"Mycobacterial FadD proteins (fatty acid CoA- and AMP- ligases)"	"Mycobacterial FadD proteins (fatty acid CoA- and AMP- ligases)"
"Mycobacterial FadE proteins Acyl-CoA dehydrogenase"	"Mycobacterial FadE proteins Acyl-CoA dehydrogenase"
"Mycobacterial gene cluster associated with resistance against FAS-II antibiotics"	"Mycobacterial gene cluster associated with resistance against FAS-II antibiotics"
"Mycobacterial HadABC proteins ((3R)-hydroxyacyl-ACP dehydrates of FASII)"	"Mycobacterial HadABC proteins ((3R)-hydroxyacyl-ACP dehydrates of FASII)"
"Mycobacterial heme acquisition system"	"Mycobacterial heme acquisition system"
"Mycobacterial lipid and multidrug efflux system proteins MmpL, MmpS"	"Mycobacterial lipid and multidrug efflux system proteins MmpL, MmpS"
"Mycobacterial lipoproteins (LPR group)"	"Mycobacterial lipoproteins (LPR group)"
"Mycobacterial multidrug efflux systems implicated in AMR"	"Mycobacterial multidrug efflux systems implicated in AMR"
"Mycobacterial signal transduction system MprAB required for persistent infections"	"Mycobacterial signal transduction system MprAB required for persistent infections"
"Mycobacterium tuberculosis complex (MTBC)"	"Mycobacterium tuberculosis complex (MTBC)"
"Mycofactocin system cluster"	"Mycofactocin system cluster"
"Mycolic acid synthesis 2"	"Mycolic acid synthesis 2"
"Mycosporine synthesis cluster"	"Mycosporine synthesis cluster"
"N-acetylneuraminate utilization"	"N-acetylneuraminate utilization"
"N,N'-diacetylbacillosamine"	"N,N'-diacetylbacillosamine"
"Na-driven 2-hydroxyglutarate pathway"	"Na-driven 2-hydroxyglutarate pathway"
"Na-translocating NADH-quinone oxidoreductase"	"Na-translocating NADH-quinone oxidoreductase"
"Na(+) H(+) antiporter"	"NhaA, NhaD and Sodium-dependent phosphate transporters!Na(+) H(+) antiporter"
"NAD and NADP cofactor biosynthesis bacterial"	"NAD and NADP cofactor biosynthesis bacterial!NAD and NADP cofactor biosynthesis global"
"NAD and NADP cofactor biosynthesis global"	"NAD and NADP cofactor biosynthesis bacterial!NAD and NADP cofactor biosynthesis global"
"NAD-reducing [NiFe] hydrogenase HoxFUYH(E)"	"NAD-reducing [NiFe] hydrogenase HoxFUYH(E)"
"NADH ubiquinone oxidoreductase"	"Respiratory Complex I!NADH ubiquinone oxidoreductase!Multi-subunit cation antiporter!Respiratory complex I in plants (plastidial) and cyanobacteria!NADH ubiquinone oxidoreductase vs. multi-subunit cation antiporter"
"NADH ubiquinone oxidoreductase vs. multi-subunit cation antiporter"	"Respiratory Complex I!NADH ubiquinone oxidoreductase!Multi-subunit cation antiporter!Respiratory complex I in plants (plastidial) and cyanobacteria!NADH ubiquinone oxidoreductase vs. multi-subunit cation antiporter"
"NADP-reducing [FeFe]-hydrogenase"	"NADP-reducing [FeFe]-hydrogenase"
"NADP-reducing [FeFe]-hydrogenase"	"NADP-reducing [FeFe]-hydrogenase"
"NhaA, NhaD and Sodium-dependent phosphate transporters"	"NhaA, NhaD and Sodium-dependent phosphate transporters!Na(+) H(+) antiporter"
"Nickel-requiring"	"Nickel-requiring"
"Nicotinate catabolism, anaerobic"	"Nicotinate catabolism, anaerobic"
"Nicotinic acid utilization"	"Nicotinic acid utilization"
"NiFe hydrogenase maturation"	"NiFe hydrogenase maturation"
"Nitrilase"	"Nitrilase"
"Nitrogen fixation"	"Nitrogen fixation"
"Nonmevalonate Branch of Isoprenoid Biosynthesis"	"Nonmevalonate Branch of Isoprenoid Biosynthesis"
"Nucleoside ABC transporter cluster"	"Nucleoside ABC transporter cluster"
"Nucleoside triphosphate pyrophosphohydrolase MazG"	"Nucleoside triphosphate pyrophosphohydrolase MazG"
"Nucleoside uptake and degradation cluster"	"Nucleoside uptake and degradation cluster"
"Nudix proteins (nucleoside triphosphate hydrolases)"	"Nudix proteins (nucleoside triphosphate hydrolases)"
"O-methyl phosphoramidate modification in capsular polysaccharide"	"O-methyl phosphoramidate modification in capsular polysaccharide"
"Oligopeptide degradation cluster"	"Oligopeptide degradation cluster"
"One-carbon metabolism by tetrahydropterines"	"One-carbon metabolism by tetrahydropterines"
"Osmoregulation"	"Osmoregulation"
"Osmotic stress cluster"	"Osmotic stress cluster"
"Outer membrane"	"Outer membrane porins in Mycobacteria"
"Outer membrane porins in Mycobacteria"	"Outer membrane porins in Mycobacteria"
"Outer membrane porins in Pseudomonas and Acinetobacter"	"Outer membrane porins in Pseudomonas and Acinetobacter"
"Outer membrane proteases (Omptins)"	"Outer membrane proteases (Omptins)"
"Oxaloacetate decarboxylase Na-pump"	"Oxaloacetate decarboxylase Na-pump"
"Oxygen-sensing diguanylate cyclase and phosphodiesterase couple for c-di-GMP control"	"Cyclic Di-GMP Turnover Proteins!Oxygen-sensing diguanylate cyclase and phosphodiesterase couple for c-di-GMP control"
"Oxygen-sensing two-component regulatory system NreABC"	"Oxygen-sensing two-component regulatory system NreABC"
"p-Aminobenzoyl-Glutamate Utilization"	"p-Aminobenzoyl-Glutamate Utilization"
"P2-like phage"	"P2-like phage"
"Particulate methane monooxygenase (pMMO)"	"Particulate methane monooxygenase (pMMO)"
"PE multigene family in Mycobacterium tuberculosis complex (MTBC)"	"PE multigene family in Mycobacterium tuberculosis complex (MTBC)"
"PEB1, the major cell-binding factor of Campylobacter jejuni"	"PEB1, the major cell-binding factor of Campylobacter jejuni"
"Pentalenolactone Biosynthesis and Resistance"	"Pentalenolactone Biosynthesis and Resistance"
"Pentose phosphate pathway"	"Pentose phosphate pathway"
"Peptidase clustering with DAP"	"Peptidase clustering with DAP!Dipicolinate Synthesis"
"Peptide ABC transport system Sap"	"Peptide ABC transport system Sap"
"Peptide methionine sulfoxide reductase"	"Peptide methionine sulfoxide reductase"
"Peptidyl-prolyl cis-trans isomerase"	"Peptidyl-prolyl cis-trans isomerase"
"Perchlorate reduction"	"Perchlorate reduction"
"Periplasmic disulfide interchange"	"Periplasmic disulfide interchange"
"Periplasmic nitrate reductase EC 1.7.99.4"	"Periplasmic nitrate reductase EC 1.7.99.4"
"Pertussis toxin"	"Toxins!Pertussis toxin!Cytolethal distending toxins"
"Phage shock protein operon"	"Phage shock protein operon"
"Phd-Doc, YdcE-YdcD toxin-antitoxin (programmed cell death) systems"	"Phd-Doc, YdcE-YdcD toxin-antitoxin (programmed cell death) systems"
"Phenazine biosynthesis"	"Phenazine biosynthesis"
"Phenol hydroxylase"	"Phenol hydroxylase"
"Phenylacetyl-CoA catabolic pathway (core)"	"Phenylacetyl-CoA catabolic pathway (core)"
"Phenylalanine and Tyrosine synthesis 1"	"Phenylalanine and Tyrosine synthesis 1"
"Phosphatidylinositol mannosides biosynthesis related cluster"	"Phosphatidylinositol mannosides biosynthesis related cluster"
"Phosphoenolpyruvate phosphomutase"	"Phosphoenolpyruvate phosphomutase"
"Phosphoethanolamine transferases"	"Phosphoethanolamine transferases"
"Phospholipid and Fatty acid biosynthesis related cluster"	"Phospholipid and Fatty acid biosynthesis related cluster"
"Phosphonate (phosphite) dehydrogenase"	"Phosphonate (phosphite) dehydrogenase"
"Phosphonate metabolism"	"Phosphonate metabolism"
"Phosphonoalanine utilization"	"Phosphonoalanine utilization"
"Photorespiration (oxidative C2 cycle)"	"Photorespiration (oxidative C2 cycle)"
"Photosystem I"	"Photosystem I"
"Photosystem I-type photosynthetic reaction center"	"Photosystem I-type photosynthetic reaction center"
"Photosystem II"	"Photosystem II"
"Photosystem II-type photosynthetic reaction center"	"Photosystem II-type photosynthetic reaction center"
"Phr peptides - Rap phosphatases signaling"	"Phr peptides - Rap phosphatases signaling"
"Plasmid replication"	"Plasmid replication"
"Poly-gamma-glutamate biosynthesis"	"Poly-gamma-glutamate biosynthesis"
"Polyadenylation, bacterial"	"Polyadenylation, bacterial"
"Polyamine Metabolism"	"Polyamine Metabolism"
"Polymyxin resistance"	"Polymyxin resistance!Polymyxin resistance, lipid A modifications with 4-amino-4-deoxy-L-arabinose"
"Polymyxin resistance, lipid A modifications with 4-amino-4-deoxy-L-arabinose"	"Polymyxin resistance!Polymyxin resistance, lipid A modifications with 4-amino-4-deoxy-L-arabinose"
"Polymyxin resistance, lipid A modifications with phosphoethanolamine"	"Polymyxin resistance, lipid A modifications with phosphoethanolamine"
"Polysulfide reductase EC 1.12.98.4 and Thiosulfate reductase"	"Polysulfide reductase EC 1.12.98.4 and Thiosulfate reductase"
"Polyunsaturated Fatty Acids synthesis"	"Alkane synthesis in bacteria 2!Head-to-head olefinic hydrocarbon biosynthesis!Polyunsaturated Fatty Acids synthesis"
"Pore-forming cytolytic toxins"	"Pore-forming cytolytic toxins"
"Possible DNA repair related cluster"	"Possible DNA repair related cluster"
"Possible heterocyst differentiation related cluster"	"Possible heterocyst differentiation related cluster"
"Possible new toxin-antitoxin system including DivIC"	"Possible new toxin-antitoxin system including DivIC"
"Possible RNA modification and stress response cluster"	"Possible RNA modification and stress response cluster"
"Possible stress related actinobacterial cluster"	"Possible stress related actinobacterial cluster"
"Post-translational modification of proteins"	"Post-translational modification of proteins"
"Potassium-transporting ATPase"	"Potassium-transporting ATPase"
"Potential DNA repair cluster"	"Potential DNA repair cluster"
"PPE multigene family in Mycobacterium tuberculosis complex (MTBC)"	"PPE multigene family in Mycobacterium tuberculosis complex (MTBC)"
"Predicted secretion system W clustering with cell division proteins"	"Predicted secretion system W clustering with cell division proteins"
"Predicted secretion system X"	"Predicted secretion system X"
"Prefoldin"	"Prefoldin"
"Prenylated indole derivatives in actinomycetes"	"Prenylated indole derivatives in actinomycetes!G-protein-coupled receptor (GPCR) system in Actinobacteria"
"PrlS-PrlR Two-Component Regulatory System of Brucella"	"PrlS-PrlR Two-Component Regulatory System of Brucella"
"Programmed cell death toxin-antitoxin PezAT"	"Programmed cell death toxin-antitoxin PezAT"
"Programmed frameshift"	"Programmed frameshift"
"Proline biosynthesis (for review)"	"Proline Synthesis!Proline biosynthesis (for review)"
"Proline Synthesis"	"Proline Synthesis!Proline biosynthesis (for review)"
"Proline, 4-hydroxyproline uptake and utilization"	"Proline, 4-hydroxyproline uptake and utilization"
"Propanediol utilization"	"Propanediol utilization"
"Proteasome bacterial"	"Proteasome bacterial"
"Protection from Reactive Oxygen Species"	"Protection from Reactive Oxygen Species"
"Protein chaperones"	"Protein chaperones"
"Protein degradation"	"Protein degradation"
"Protein-O-mannosyltransferase and 16S rRNA (cytidine(1402)-2'-O)-methyltransferase cluster"	"Protein-O-mannosyltransferase and 16S rRNA (cytidine(1402)-2'-O)-methyltransferase cluster"
"Proteorhodopsin"	"Proteorhodopsin"
"Pterin synthesis related cluster"	"Pterin synthesis related cluster"
"Purine catabolism in Bacillus subtilis"	"Purine catabolism in Bacillus subtilis"
"Purine nucleotide synthesis regulator"	"Purine nucleotide synthesis regulator"
"Putative oxidase COG2907"	"Putative oxidase COG2907"
"Putative TldE-TldD proteolytic complex"	"Putative TldE-TldD proteolytic complex"
"Putrescine utilization"	"Putrescine utilization"
"Pyridoxin (Vitamin B6) Biosynthesis"	"Pyridoxin (Vitamin B6) Biosynthesis"
"Pyridoxin(Vitamin B6) Degradation Pathway"	"Pyridoxin(Vitamin B6) Degradation Pathway"
"Pyrroloquinoline Quinone biosynthesis"	"Coenzyme PQQ synthesis!Pyrroloquinoline Quinone biosynthesis"
"Pyrrolysine"	"Pyrrolysine!tRNA aminoacylation, Pyr"
"Pyruvate Alanine Serine Interconversions"	"L-serine dehydratase subunits!Pyruvate Alanine Serine Interconversions"
"Pyruvate formate-lyase cluster"	"Pyruvate formate-lyase cluster!Pyruvate formate-lyase cluster with possible role in choline utilization"
"Pyruvate formate-lyase cluster with possible role in choline utilization"	"Pyruvate formate-lyase cluster!Pyruvate formate-lyase cluster with possible role in choline utilization"
"Pyruvate metabolism I: anaplerotic reactions, PEP"	"Pyruvate metabolism I: anaplerotic reactions, PEP"
"Pyruvate metabolism II: acetyl-CoA, acetogenesis from pyruvate"	"Pyruvate metabolism II: acetyl-CoA, acetogenesis from pyruvate"
"Pyruvate:ferredoxin oxidoreductase"	"Pyruvate:ferredoxin oxidoreductase"
"Queuosine and archaeosine"	"Queuosine and archaeosine"
"Quinolone (Fluoroquinolone) resistance via Pentapeptide repeat proteins"	"Quinolone (Fluoroquinolone) resistance via Pentapeptide repeat proteins"
"Quinone oxidoreductase family"	"Quinone oxidoreductase family"
"Quorum sensing in Yersinia"	"Quorum sensing in Yersinia"
"Quorum-sensing related cluster"	"Quorum-sensing related cluster"
"Rcn nickel and cobalt homeostasis system"	"Rcn nickel and cobalt homeostasis system"
"Rcs two-component regulator of capsule synthesis"	"Rcs two-component regulator of capsule synthesis"
"RecA and RecX"	"DNA repair system including RecA, MutS and a hypothetical protein!RecA and RecX"
"Reductive Dechlorination"	"Reductive Dechlorination"
"Repair of Iron Centers"	"Repair of Iron Centers"
"Replication-associated recombination protein RarA"	"Replication-associated recombination protein RarA"
"Resistance to chromium compounds"	"Resistance to chromium compounds"
"Resistance to Daptomycin"	"Resistance to Daptomycin"
"Resistance to Ethambutol"	"Resistance to Ethambutol"
"Resistance to Ethionamide and Isoniazid"	"Resistance to Ethionamide and Isoniazid"
"Resistance to the fluoroquinolones norfloxacin and ciprofloxacin"	"Resistance to the fluoroquinolones norfloxacin and ciprofloxacin"
"Resistance to Triclosan"	"Fatty acid synthesis!Fatty Acid Biosynthesis FASII!Enoyl-[ACP] reductases disambiguation!Fatty Acid Biosynthesis cluster!Acyl carrier protein!Resistance to Triclosan"
"Resistance to Vancomycin and Teicoplanin"	"Resistance to Vancomycin and Teicoplanin"
"Respiratory Complex I"	"Respiratory Complex I!NADH ubiquinone oxidoreductase!Multi-subunit cation antiporter!Respiratory complex I in plants (plastidial) and cyanobacteria!NADH ubiquinone oxidoreductase vs. multi-subunit cation antiporter"
"Respiratory complex I in plants (plastidial) and cyanobacteria"	"Respiratory Complex I!NADH ubiquinone oxidoreductase!Multi-subunit cation antiporter!Respiratory complex I in plants (plastidial) and cyanobacteria!NADH ubiquinone oxidoreductase vs. multi-subunit cation antiporter"
"Respiratory Systems - Shewanella (updated)"	"Fe(III) respiration - Shewanella type!Respiratory Systems - Shewanella (updated)"
"Ribitol utilization"	"Ribitol utilization"
"Riboflavin, FMN and FAD biosynthesis in Archaea"	"Riboflavin, FMN and FAD biosynthesis in Archaea"
"Riboflavin, FMN and FAD metabolism with fusion events"	"Riboflavin, FMN and FAD metabolism with fusion events"
"Ribonuclease H"	"Ribonuclease H"
"Ribonuclease J family"	"Ribonuclease J family"
"Ribonuclease P, archaeal and eukaryal"	"Ribonuclease P, archaeal and eukaryal"
"Ribonucleotide reduction"	"Ribonucleotide reduction"
"Ribosomal hibernation related cluster"	"Lipopolysaccharide transporter LptABC!Lpt lipopolysaccharide transport system!Ribosomal hibernation related cluster"
"Ribosomal protein S12p Asp methylthiotransferase"	"Ribosomal protein S12p Asp methylthiotransferase!Methylthiotransferases"
"Ribosomal protein S5p acylation"	"Ribosomal protein S5p acylation"
"Ribosomal proteins, single-copy"	"Ribosomal proteins, single-copy"
"Ribosomal proteins, zinc requirement"	"Ribosomal proteins, zinc requirement"
"Ribosome activity modulation"	"Ribosome activity modulation"
"Ribosome biogenesis, archaeal"	"Ribosome biogenesis, archaeal"
"Ribosome LSU, bacterial"	"Ribosome LSU, bacterial"
"Ribosome LSU, eukaryotic and archaeal"	"Ribosome LSU, eukaryotic and archaeal"
"Ribosome SSU, eukaryotic and archaeal"	"Ribosome SSU, eukaryotic and archaeal"
"RNA polymerase, archaeal"	"RNA polymerase, archaeal"
"RNA polymerase, archaeal initiation factors"	"RNA polymerase, archaeal initiation factors"
"RNA polymerase, bacterial"	"RNA polymerase, bacterial"
"RNA processing and degradation, bacterial"	"RNA processing and degradation, bacterial"
"RNA pseudouridine synthases"	"RNA pseudouridine synthases"
"rRNA modification related cluster including tlyA"	"rRNA modification related cluster including tlyA"
"RuBisCO operon"	"RuBisCO operon"
"Rut pathway of pyrimidine degradation"	"Rut pathway of pyrimidine degradation"
"RuvABC plus a hypothetical"	"RuvABC plus a hypothetical"
"S-Adenosyl-L-homocysteine recycling"	"S-Adenosyl-L-homocysteine recycling"
"S-methylmethionine"	"S-methylmethionine"
"Salmochelin-mediated Iron Acquisition"	"Salmochelin-mediated Iron Acquisition"
"Sarcosine oxidases, monomeric and heterotetrameric"	"Sarcosine oxidases, monomeric and heterotetrameric"
"SecY2-SecA2 Specialized Transport System"	"SecY2-SecA2 Specialized Transport System"
"Selenocysteine metabolism"	"Selenocysteine metabolism"
"Selenoprotein O"	"Selenoprotein O"
"Sex pheromones in Enterococcus faecalis and other Firmicutes"	"Sex pheromones in Enterococcus faecalis and other Firmicutes"
"Shiga toxin (Stx)"	"Shiga toxin (Stx)"
"Shikimate kinase SK3 cluster"	"Shikimate kinase SK3 cluster"
"Siderophore [Alcaligin-like]"	"Siderophore [Alcaligin-like]"
"Siderophore Achromobactin"	"Siderophore Achromobactin"
"Siderophore Aerobactin"	"Siderophore Aerobactin"
"Siderophore Anthrachelin"	"Siderophore Anthrachelin"
"Siderophore assembly kit"	"Siderophore assembly kit"
"Siderophore brucebactin"	"Siderophore brucebactin"
"Siderophore Desferrioxamine E"	"Siderophore Desferrioxamine E"
"Siderophore Enterobactin"	"Siderophore Enterobactin"
"Siderophore Mycobactin"	"Siderophore Mycobactin"
"Siderophore pyochelin"	"Siderophore pyochelin"
"Siderophore Pyoverdine"	"Siderophore Pyoverdine"
"Siderophore Staphylobactin"	"Siderophore Staphylobactin"
"Siderophore Yersiniabactin Biosynthesis"	"Siderophore Yersiniabactin Biosynthesis"
"Sigma54-dependent transcription related gene cluster"	"Sigma54-dependent transcription related gene cluster"
"Sigma54-dependent transcription related gene cluster 2"	"Sigma54-dependent transcription related gene cluster 2"
"Signal peptidase"	"Signal peptidase"
"Small efflux transporters of SMR family"	"Small efflux transporters of SMR family"
"Sodium-transporting ATPase"	"Sodium-transporting ATPase"
"Soluble methane monooxygenase (sMMO)"	"Soluble methane monooxygenase (sMMO)"
"Sox sulfur oxidation genes"	"Sox sulfur oxidation genes"
"Sox thiosulfate oxidation system"	"Sox thiosulfate oxidation system"
"Spore germinant receptors"	"Spore germinant receptors"
"Spore germination"	"Spore germination"
"Sporulation Cluster"	"Sporulation Cluster"
"Sporulation Cluster III A"	"Sporulation Cluster III A!Sporulation proteins SpoIIIAA-SpoIIIAH"
"Sporulation gene orphans"	"Sporulation gene orphans"
"Sporulation proteins SigEG cluster"	"Sporulation proteins SigEG cluster"
"Sporulation proteins SpoIIIAA-SpoIIIAH"	"Sporulation Cluster III A!Sporulation proteins SpoIIIAA-SpoIIIAH"
"Sporulation proteins SpoVA cluster"	"Sporulation proteins SpoVA cluster"
"Sporulation-associated proteins with broader functions"	"Sporulation-associated proteins with broader functions"
"SpoVS protein family"	"SpoVS protein family"
"Streptococcal Hyaluronic Acid Capsule"	"Hyaluronic Acid-containing Cell Walls!Streptococcal Hyaluronic Acid Capsule"
"Streptolysin S"	"Streptolysin S"
"Stress proteins YciF, YciE"	"Stress proteins YciF, YciE"
"Stress response and cell wall lysis cluster"	"Stress response and cell wall lysis cluster"
"Stringent Response, (p)ppGpp metabolism"	"Stringent Response, (p)ppGpp metabolism"
"Succinate dehydrogenase and Fumarate reductase cpmlexes"	"Succinate dehydrogenase and Fumarate reductase cpmlexes"
"Sucrose to levan conversions"	"Sucrose to levan conversions"
"Sugar-phosphate stress regulation"	"Sugar-phosphate stress regulation"
"Sulfate assimilation related cluster"	"Adenylylsulfate reductase!Sulfate assimilation related cluster"
"Sulfate reduction-associated complexes"	"Sulfate reduction-associated complexes"
"Sulfhydrogenase"	"Sulfhydrogenase"
"Sulfoquinovose biosynthesis cluster"	"Sulfoquinovose biosynthesis cluster"
"Sulfur metabolism related cluster"	"Sulfur metabolism related cluster"
"Sulfur transfer pathway CsdAEL"	"Sulfur transfer pathway CsdAEL"
"Sulfur transport related cluster"	"Sulfur transport related cluster"
"Sulfurtransferase and Ssec cluster"	"Sulfurtransferase and Ssec cluster"
"Sulphoglycolysis"	"Sulphoglycolysis"
"Tagatose utilization"	"Tagatose utilization"
"TAM transport system"	"TAM transport system"
"Taurine and alkanesulfonate utilization as sulfur sources"	"Taurine and alkanesulfonate utilization as sulfur sources"
"TCA Cycle"	"TCA Cycle!2-oxoglutarate dehydrogenase!Lipoylated proteins"
"Teichuronic acid biosynthesis"	"Teichuronic acid biosynthesis"
"Teicoplanin resistance in Staphylococci"	"Teicoplanin resistance in Staphylococci"
"Tetracycline resistance, all mechanisms"	"Tetracycline resistance, ribosomal protection type!Tetracycline resistance, all mechanisms"
"Tetracycline resistance, ribosomal protection type"	"Tetracycline resistance, ribosomal protection type!Tetracycline resistance, all mechanisms"
"Tetrathionate respiration"	"Tetrathionate respiration"
"The Chv two-component regulatory system"	"The Chv two-component regulatory system"
"Thiamin, hydroxymethylpyrimidine selected transporters"	"Thiamin, hydroxymethylpyrimidine selected transporters!Thiamin, thiazole, hydroxymethylpyrimidine salvage and uptake"
"Thiamin, thiazole, hydroxymethylpyrimidine salvage and uptake"	"Thiamin, hydroxymethylpyrimidine selected transporters!Thiamin, thiazole, hydroxymethylpyrimidine salvage and uptake"
"Thiazole.oxazole-modified microcins"	"Thiazole.oxazole-modified microcins"
"Thiocyanate hydrolase"	"Thiocyanate hydrolase"
"Threonine anaerobic catabolism gene cluster"	"Threonine anaerobic catabolism gene cluster"
"Threonine synthase cluster"	"Threonine synthase cluster"
"Threonylcarbamoyladenosine"	"YrdC-YciO-Sua5 and associated protein families!Threonylcarbamoyladenosine"
"Tmc complex"	"Tmc complex"
"Tocopherols and tocotrienols (vitamin E) in plants and cyanobacteria"	"Tocopherols and tocotrienols (vitamin E) in plants and cyanobacteria"
"Tol-Pal Cell Envelope Complex"	"Tol-Pal Cell Envelope Complex"
"Tolerance to colicin E2 and CreBC signal transduction system"	"Tolerance to colicin E2 and CreBC signal transduction system"
"Toluene 4-monooxygenase (T4MO)"	"Toluene 4-monooxygenase (T4MO)"
"TonB-ExbBD energy transducing system"	"TonB-ExbBD energy transducing system"
"Toxin co-regulated pilus"	"Toxin co-regulated pilus"
"Toxin-Antitoxin MT1"	"Toxin-Antitoxin MT1"
"Toxin-Antitoxin system HigAB"	"Toxin-Antitoxin system HigAB"
"Toxins"	"Toxins!Pertussis toxin!Cytolethal distending toxins"
"Trans-envelope signaling system VreARI in Pseudomonas"	"Trans-envelope signaling system VreARI in Pseudomonas"
"Trans-translation by stalled ribosomes"	"Trans-translation by stalled ribosomes!Translation termination factors, bacterial"
"Transcription elongation factors, archaeal"	"Transcription elongation factors, archaeal"
"Transcription factors, cyanobacterial RpoD-like sigma factors"	"Transcription factors, cyanobacterial RpoD-like sigma factors"
"Transcriptional regulator AfsR"	"Transcriptional regulator AfsR"
"Transcriptional regulators implicated in bedaquiline tolerance"	"Transcriptional regulators implicated in bedaquiline tolerance"
"Translation elongation factor G family"	"Translation elongation factor G family"
"Translation elongation factors, bacterial"	"Translation elongation factors, bacterial"
"Translation elongation factors, eukaryotic and archaeal"	"Translation elongation factors, eukaryotic and archaeal"
"Translation initiation factors, bacterial"	"Translation initiation factors, bacterial"
"Translation initiation factors, eukaryotic and archaeal"	"Translation initiation factors, eukaryotic and archaeal"
"Translation termination factors, bacterial"	"Trans-translation by stalled ribosomes!Translation termination factors, bacterial"
"Tricarballylate Utilization"	"Tricarballylate Utilization"
"Tricarboxylate transport system"	"Tricarboxylate transport system"
"Trimethylamine-N-oxide operon"	"Trimethylamine-N-oxide operon"
"Tripartite efflux system (of RND type) associated with Geranylgeranyl-PP synthase"	"Tripartite efflux system (of RND type) associated with Geranylgeranyl-PP synthase"
"Tripartite multidrug efflux systems (of MFS type) EmrKY-TolC and EmrAB-TolC"	"Tripartite multidrug efflux systems (of MFS type) EmrKY-TolC and EmrAB-TolC"
"Tripartite multidrug efflux systems (of MFS type) in Gram-negative bacteria"	"Tripartite multidrug efflux systems (of MFS type) in Gram-negative bacteria!Multidrug Resistance, Tripartite Systems Found in Gram Negative Bacteria TEMP"
"Tripartite multidrug efflux systems (of RND type) AcrAB-TolC and related transporters"	"Tripartite multidrug efflux systems (of RND type) AcrAB-TolC and related transporters"
"Tripartite multidrug efflux systems (of RND type) CmeABC and CmeDEF"	"Tripartite multidrug efflux systems (of RND type) CmeABC and CmeDEF"
"Tripartite multidrug efflux systems (of RND type) in Pseudomonas"	"Tripartite multidrug efflux systems (of RND type) MdtABC-TolC!MexXY System of Pseudomonas aeruginosa!Tripartite multidrug efflux systems (of RND type) in Pseudomonas"
"Tripartite multidrug efflux systems (of RND type) MdtABC-TolC"	"Tripartite multidrug efflux systems (of RND type) MdtABC-TolC!MexXY System of Pseudomonas aeruginosa!Tripartite multidrug efflux systems (of RND type) in Pseudomonas"
"Trk and Ktr potassium uptake systems"	"Trk and Ktr potassium uptake systems!Hyperosmotic potassium uptake"
"tRNA aminoacylation, Ala"	"tRNA aminoacylation, Ala"
"tRNA aminoacylation, Arg"	"tRNA aminoacylation, Arg"
"tRNA aminoacylation, Asn"	"tRNA aminoacylation, Asp!tRNA aminoacylation, Asn"
"tRNA aminoacylation, Asp"	"tRNA aminoacylation, Asp!tRNA aminoacylation, Asn"
"tRNA aminoacylation, Cys"	"tRNA aminoacylation, Cys"
"tRNA aminoacylation, Gln"	"tRNA aminoacylation, Glu!tRNA aminoacylation, Gln"
"tRNA aminoacylation, Glu"	"tRNA aminoacylation, Glu!tRNA aminoacylation, Gln"
"tRNA aminoacylation, Gly"	"tRNA aminoacylation, Gly!Glycyl-tRNA synthetase"
"tRNA aminoacylation, His"	"tRNA aminoacylation, His"
"tRNA aminoacylation, Ile"	"Mupirocin resistance!tRNA aminoacylation, Ile"
"tRNA aminoacylation, Leu"	"tRNA aminoacylation, Leu"
"tRNA aminoacylation, Lys"	"tRNA aminoacylation, Lys"
"tRNA aminoacylation, Met"	"tRNA aminoacylation, Met"
"tRNA aminoacylation, Phe"	"tRNA aminoacylation, Phe"
"tRNA aminoacylation, Pro"	"tRNA aminoacylation, Pro"
"tRNA aminoacylation, Pyr"	"Pyrrolysine!tRNA aminoacylation, Pyr"
"tRNA aminoacylation, Ser"	"tRNA aminoacylation, Ser"
"tRNA aminoacylation, Thr"	"tRNA aminoacylation, Thr"
"tRNA aminoacylation, Trp"	"tRNA aminoacylation, Trp"
"tRNA aminoacylation, Tyr"	"D-tyrosyl-tRNA(Tyr) deacylase!tRNA aminoacylation, Tyr"
"tRNA aminoacylation, Val"	"tRNA aminoacylation, Val"
"tRNA modification, 5-oxyacetyl uridine (cmo5U34)"	"tRNA modification, 5-oxyacetyl uridine (cmo5U34)"
"tRNA nucleotidyltransferase"	"tRNA nucleotidyltransferase"
"tRNA splicing"	"tRNA splicing"
"tRNA thiolation"	"tRNA thiolation"
"Tryptophan synthesis"	"Tryptophan synthesis"
"Twin-arginine translocation system"	"Twin-arginine translocation system"
"Twin-arginine translocation system related cluster"	"Twin-arginine translocation system related cluster"
"Two cell division clusters relating to chromosome partitioning"	"Two cell division clusters relating to chromosome partitioning"
"Two partner secretion pathway (TPS)"	"Two partner secretion pathway (TPS)"
"Type 4 conjugative transfer system, IncI1 type"	"Type 4 conjugative transfer system, IncI1 type"
"Type 4 secretion and conjugative transfer"	"Type 4 secretion and conjugative transfer"
"Type I restriction-modification systems"	"Type I restriction-modification systems"
"Type I secretion systems disambiguation"	"Type I secretion systems disambiguation"
"Type III secretion system"	"Type III secretion system"
"Type III secretion system orphans"	"Type III secretion system orphans"
"Type III secretion systems"	"Type III secretion systems"
"Type IV pilus"	"Type IV pilus"
"Type VI secretion system"	"Type VI secretion system"
"Ubiquinone biosynthesis"	"Ubiquinone biosynthesis"
"Ubiquitin-like archaeal modifier proteins (SAMPs)"	"Ubiquitin-like archaeal modifier proteins (SAMPs)"
"Undecaprenyl-diphosphatases"	"Undecaprenyl-diphosphatases"
"Universal GTPases"	"Universal GTPases"
"Universal stress protein family"	"Universal stress protein family"
"Urea carboxylase and Allophanate hydrolase cluster"	"Urea carboxylase and Allophanate hydrolase cluster"
"Urea cycle"	"Urea cycle"
"Urease subunits"	"Urease subunits"
"Uridine to beta-Alanine and Thymine to 3-aminoisobutanoate module"	"Dihydropyrimidine dehydrogenase!Uridine to beta-Alanine and Thymine to 3-aminoisobutanoate module"
"Utilization systems for glycans and polysaccharides (PULs, SUS)"	"Utilization systems for glycans and polysaccharides (PULs, SUS)"
"V-Type ATP synthase"	"V-Type ATP synthase"
"Vancomycin resistance, D-Ala-D-Ala dipeptidases and carboxypeptidases"	"Vancomycin resistance, D-Ala-D-Ala dipeptidases and carboxypeptidases"
"Vancomycin resistance, D-Ala-D-Ser, D-Ala-Lac ligases"	"Vancomycin resistance, D-Ala-D-Ser, D-Ala-Lac ligases"
"Vanillate and syringate utilization"	"Vanillate and syringate utilization"
"Vibrioferrin synthesis"	"Vibrioferrin synthesis"
"Violacein biosynthesis"	"Violacein biosynthesis"
"Vir-like type 4 secretion system"	"Vir-like type 4 secretion system"
"VraTSR and LiaFSR three-component regulatory systems"	"VraTSR and LiaFSR three-component regulatory systems"
"Wall polysaccharide pyruvylation"	"Wall polysaccharide pyruvylation"
"Widespread colonization island"	"Widespread colonization island"
"Xanthine dehydrogenase subunits"	"Xanthine dehydrogenase subunits"
"YoeB-YefM toxin-antitoxin system"	"YoeB-YefM toxin-antitoxin system!Toxin-antitoxin replicon stabilization systems"
"Toxin-antitoxin replicon stabilization systems"	"YoeB-YefM toxin-antitoxin system!Toxin-antitoxin replicon stabilization systems"
"YrdC-YciO-Sua5 and associated protein families"	"YrdC-YciO-Sua5 and associated protein families!Threonylcarbamoyladenosine"
"ZraPRS-based zinc resistance"	"ZraPRS-based zinc resistance"
"Zwittermicin A resistance"	"Zwittermicin A resistance"
